w,w,w,w,w,w,w,w,w,w,w,w,w,w,w,w,w,w,w,w,w,w,w,w,w,w,w,w,w,w,w,w,w,w,w,w,w,w,w,w,w,w,w,w,w,w,w,w,w,w,w,w,w,w,w,w,w,w,w,b
w,w,w,w,w,w,w,w,w,w,w,w,w,w,w,w,w,w,w,w,w,w,w,w,w,w,w,w,w,w,w,w,w,w,w,w,w,w,w,w,w,w,w,w,w,w,w,w,w,w,r,w,w,w,w,w,b,w,w,w
w,w,w,w,w,w,w,w,w,w,w,w,w,w,w,w,w,w,w,w,w,w,w,w,b,w,w,w,w,w,w,w,w,w,w,w,w,w,w,w,w,w,w,w,w,w,w,w,w,w,w,w,r,w,w,w,w,w,w,w
w,w,w,w,w,w,w,w,w,w,w,w,w,w,w,w,w,w,w,w,w,w,w,w,w,w,w,w,w,w,w,w,w,w,w,w,w,w,w,w,w,w,w,w,w,w,w,w,w,w,w,w,w,w,r,w,w,w,w,w
w,w,w,w,w,w,w,w,w,w,w,w,w,w,w,w,w,w,w,w,w,w,w,w,w,w,w,w,w,w,w,w,w,w,w,w,w,w,w,w,w,w,w,w,w,w,w,w,w,w,r,w,w,r,r,r,w,w,w,w
w,w,w,w,w,w,w,w,w,w,w,w,w,w,w,w,w,w,w,w,w,w,w,w,w,w,w,w,w,w,w,w,w,w,w,w,w,w,w,w,w,w,f,w,w,w,w,w,w,w,w,w,r,r,r,w,w,w,w,w
w,w,w,w,w,w,w,w,w,w,w,w,w,w,w,w,w,w,w,w,w,w,w,w,w,w,w,w,w,w,w,w,w,w,w,w,w,w,w,w,w,w,w,w,w,w,w,w,w,w,w,w,w,r,r,r,w,w,w,w
w,b,w,w,w,w,w,w,w,w,r,w,w,w,f,w,w,w,w,w,w,w,w,w,w,w,w,w,w,w,w,w,w,w,w,w,w,w,w,w,w,w,w,w,w,w,w,w,w,w,w,w,w,r,r,r,r,w,w,w
w,w,w,w,w,w,w,w,w,r,r,r,w,w,w,w,w,w,w,w,w,w,w,w,w,w,w,f,w,w,w,w,w,w,w,w,w,w,w,w,w,w,w,w,w,w,w,w,w,w,w,w,r,r,r,w,r,w,w,w
w,w,w,w,w,f,w,w,w,r,r,r,w,w,w,w,w,w,w,w,f,w,w,w,w,w,w,w,w,w,w,w,f,w,w,w,w,w,w,w,w,w,w,w,w,w,w,w,w,w,w,w,w,r,r,w,w,w,w,w
w,w,w,w,w,w,w,w,r,r,r,w,w,w,w,w,w,w,w,w,w,w,w,w,w,w,w,w,w,w,w,w,w,w,w,w,w,w,w,w,w,w,w,w,w,w,w,w,w,w,w,w,w,r,w,w,w,w,w,w
w,w,w,w,w,w,w,r,r,r,w,w,w,w,w,w,w,w,w,w,w,w,w,w,w,w,w,w,w,w,w,w,t,r,r,r,r,r,r,t,w,f,w,w,w,w,w,w,w,w,w,w,w,w,w,w,w,w,w,w
w,w,w,w,w,w,w,r,r,r,w,w,w,w,w,w,w,w,w,w,w,w,w,w,w,w,w,w,w,w,w,w,w,w,w,w,w,w,w,r,w,w,w,w,w,w,w,w,w,w,w,w,w,w,w,w,w,w,w,w
w,w,w,b,w,w,w,r,w,w,f,w,w,w,w,t,r,r,r,w,w,w,w,r,t,r,w,w,f,w,w,w,w,w,w,w,w,w,w,r,w,w,w,w,w,w,w,w,w,w,w,w,w,w,w,w,w,w,w,w
w,w,w,w,w,w,r,r,r,w,w,w,w,w,w,r,w,w,w,f,w,w,w,w,w,w,w,w,w,w,w,w,r,r,r,r,r,r,f,r,w,w,w,w,w,w,w,w,w,w,w,w,w,w,w,w,w,w,w,w
w,w,w,w,w,w,r,r,r,w,w,w,w,w,w,r,w,w,w,w,w,w,w,w,w,w,w,w,w,w,w,w,r,w,f,w,f,r,w,r,w,w,w,w,w,w,w,w,w,w,w,w,w,w,w,w,w,w,w,w
w,w,w,w,w,r,r,r,r,w,w,w,w,w,w,r,w,w,w,w,w,w,w,w,w,w,w,w,w,w,w,w,r,f,g,f,w,r,w,r,w,w,w,w,w,w,w,w,w,w,w,w,w,w,w,w,w,w,w,w
w,w,w,w,w,r,r,r,r,w,w,w,w,w,w,w,w,w,w,t,r,r,r,w,w,w,r,r,r,t,w,w,r,w,f,w,f,r,w,r,w,w,w,w,w,w,w,w,w,w,w,w,w,w,w,w,w,w,w,w
w,w,w,w,r,r,r,w,w,w,w,w,w,w,f,w,w,f,w,r,w,w,w,w,f,w,w,w,w,r,w,w,r,w,f,f,w,r,w,r,w,w,w,w,w,w,w,w,w,w,w,w,w,w,w,w,w,w,w,w
w,w,w,w,r,r,w,w,w,w,w,w,w,w,w,w,w,w,w,r,w,w,w,w,w,w,w,w,w,r,w,w,r,r,r,r,r,t,w,r,w,w,w,w,w,w,w,w,w,w,w,w,w,w,w,w,w,w,w,w
w,w,w,w,r,w,w,w,w,w,w,w,w,w,w,w,w,w,w,r,w,w,w,w,w,w,w,w,w,r,w,w,r,w,w,w,w,r,w,r,w,w,w,w,w,w,w,w,w,w,w,w,w,w,w,w,w,w,w,w
w,w,w,w,w,w,w,f,w,w,w,w,w,w,w,r,w,w,w,w,w,w,a,w,w,w,w,a,w,w,w,w,r,f,w,f,w,r,w,r,w,w,w,w,w,w,w,w,w,w,w,w,w,w,w,w,w,w,w,w
w,w,w,w,w,w,w,w,w,w,w,w,w,w,w,t,w,w,w,w,w,w,w,w,w,f,w,w,w,w,w,w,r,f,w,g,f,r,w,r,w,w,w,w,w,w,w,w,w,w,w,w,w,w,w,w,w,w,w,w
w,w,w,w,w,w,w,w,w,w,w,w,w,f,w,r,w,w,w,w,w,w,w,w,w,w,w,w,w,w,w,w,r,w,f,w,w,r,w,r,w,w,w,w,w,w,w,w,w,w,w,w,w,w,w,w,w,w,w,w
w,w,w,w,w,w,w,w,w,w,w,w,w,w,w,w,w,w,w,r,w,w,w,w,w,w,f,w,f,r,w,w,r,w,w,f,w,r,w,r,w,w,w,w,w,w,w,w,w,w,w,w,w,w,w,w,w,w,w,w
w,w,w,w,w,w,w,w,w,w,w,w,w,w,w,w,w,w,w,r,w,w,w,a,w,w,w,w,w,r,w,w,r,r,r,r,r,t,w,r,w,w,w,w,w,w,w,w,w,w,w,w,w,w,w,w,w,w,w,w
w,w,w,w,w,w,w,w,w,w,w,w,w,w,w,w,w,f,w,r,w,w,w,w,w,w,w,w,w,r,w,w,r,w,f,w,w,r,w,r,w,w,w,w,w,w,w,w,w,w,w,w,w,w,w,w,w,w,w,w
w,w,w,w,w,w,f,w,w,w,w,f,w,w,w,w,w,w,w,t,r,r,r,w,w,w,r,r,r,t,w,w,r,w,f,f,f,r,w,r,w,w,w,w,w,w,w,w,w,w,w,w,w,w,w,w,w,w,w,w
w,w,w,w,w,w,w,w,w,w,w,w,w,w,w,r,w,w,w,w,w,w,w,f,w,w,w,w,w,w,w,w,r,f,g,w,w,r,w,r,w,w,w,w,w,w,w,w,w,w,w,w,w,w,w,w,w,w,w,w
w,w,w,w,w,w,w,w,w,w,w,w,w,w,w,r,w,w,w,w,w,w,w,w,w,w,w,w,w,w,w,w,r,w,w,f,w,r,w,r,w,w,w,w,w,f,w,w,w,w,w,w,w,w,w,w,w,w,w,w
w,w,w,w,w,w,w,w,w,w,w,w,w,w,w,r,w,w,w,w,w,w,w,w,w,w,w,w,f,w,w,w,r,r,r,r,r,r,w,r,w,w,w,w,w,w,w,w,w,w,w,w,w,w,w,w,w,w,w,w
w,w,w,w,w,w,w,w,f,w,w,w,w,w,w,t,r,r,r,w,w,w,w,r,t,r,w,w,w,w,w,w,w,w,w,w,w,w,w,r,w,w,w,w,w,w,w,w,w,w,w,w,w,w,w,w,w,w,w,w
w,w,w,w,w,w,w,w,w,w,w,w,w,w,w,w,w,w,w,w,w,w,w,w,w,w,w,w,w,w,w,w,t,r,r,r,r,r,r,t,w,w,w,w,w,f,w,w,w,w,w,w,w,w,w,w,w,w,w,w
w,w,w,w,w,w,w,w,w,w,w,w,w,w,f,w,w,w,f,w,w,w,w,w,w,w,w,w,w,w,f,w,w,w,w,w,w,w,w,w,w,w,w,w,w,w,w,w,w,w,w,w,w,w,w,w,w,w,w,w
w,w,w,w,w,w,w,w,w,w,w,f,w,w,w,w,w,w,w,w,w,w,w,w,w,w,w,w,w,w,w,w,w,w,w,w,w,w,w,w,w,w,w,w,w,w,w,w,w,w,w,w,w,w,w,w,w,w,w,w
w,w,w,w,w,w,w,w,w,w,w,w,w,w,w,w,w,w,w,w,w,w,w,w,w,w,w,w,w,w,w,w,w,w,w,w,w,w,w,w,w,w,w,w,w,w,w,w,w,w,w,w,w,w,w,w,w,w,w,w
w,w,w,w,w,w,w,w,w,w,w,w,w,w,w,w,w,w,w,w,w,w,f,w,w,w,w,w,w,w,w,w,w,w,w,w,w,w,w,w,f,w,w,w,w,w,w,w,w,w,w,w,w,w,w,w,w,w,w,w
w,w,w,w,w,w,w,w,w,w,w,w,w,w,w,w,w,w,w,w,w,w,w,w,w,w,w,w,w,w,w,w,w,w,w,w,w,w,w,w,w,w,w,w,w,w,w,w,w,w,w,w,w,w,w,w,w,w,w,w
w,w,w,w,w,w,w,w,w,w,w,w,w,w,w,w,w,w,w,f,w,w,w,w,w,w,w,w,w,w,w,w,w,w,f,w,w,w,w,w,w,w,w,w,w,w,w,w,w,w,w,w,w,w,w,w,w,w,w,w
w,w,w,w,w,w,w,w,w,w,w,w,w,w,w,w,w,w,w,w,w,w,w,w,w,w,w,w,w,w,w,w,w,w,w,w,w,w,w,w,w,w,w,w,w,w,w,w,w,w,w,w,w,w,w,w,w,w,w,w
w,w,w,w,w,w,w,w,w,w,w,w,w,w,w,w,w,w,w,w,w,w,w,w,w,w,w,w,w,w,w,w,w,w,w,w,w,w,w,w,w,w,w,w,w,w,w,w,w,w,w,w,w,w,w,w,w,w,w,w
w,w,w,w,w,w,w,w,w,w,w,w,w,w,r,w,w,w,w,w,w,w,w,w,r,w,w,w,w,w,w,w,w,w,w,w,w,w,w,w,w,w,w,w,w,w,w,w,w,w,w,w,w,w,w,w,w,w,w,w
w,w,w,w,w,w,w,w,w,w,w,w,w,w,w,w,w,w,w,w,w,w,w,w,w,r,w,w,w,w,w,w,w,w,w,w,w,w,w,w,w,w,w,w,w,w,w,w,w,w,w,w,w,w,w,w,w,w,w,w
w,w,w,w,w,w,w,w,w,w,w,w,w,w,w,w,w,w,w,w,w,w,w,w,w,w,w,w,w,w,w,w,w,w,w,w,w,w,w,w,w,w,w,w,w,w,w,w,w,w,w,w,w,f,w,w,w,w,w,w
w,w,w,w,w,w,w,w,w,r,w,w,w,w,w,w,f,w,w,w,w,r,w,w,w,w,w,w,w,w,w,w,w,w,w,w,w,w,w,w,w,w,w,w,w,w,w,w,w,w,w,w,w,w,w,w,w,w,w,w
w,w,w,w,w,w,w,w,w,w,w,w,w,w,w,w,w,w,w,w,r,w,w,w,w,w,w,w,w,f,w,w,w,w,w,w,w,w,w,w,w,w,w,w,w,f,w,w,w,w,w,w,w,w,w,w,w,w,w,w
w,w,w,w,w,w,w,w,w,w,w,w,w,w,w,w,w,w,w,w,w,w,w,w,w,w,w,w,w,w,w,w,w,w,w,w,w,w,w,w,w,w,w,w,w,w,w,w,w,w,w,w,w,w,w,w,w,w,w,w
w,w,w,w,w,w,w,w,w,w,w,w,w,w,w,w,w,w,w,w,w,w,w,w,w,w,w,w,w,w,w,w,w,w,w,w,w,w,w,w,w,w,w,w,w,w,w,w,w,w,w,w,w,w,w,w,w,w,w,w
w,w,w,w,w,w,w,w,w,w,w,w,w,w,w,w,w,w,w,w,w,w,w,w,w,w,w,w,w,w,w,w,w,w,w,w,w,w,w,w,w,w,w,w,w,w,w,w,w,w,w,w,w,w,w,r,r,r,w,w
w,w,w,w,r,r,r,w,w,w,w,w,w,w,w,w,w,w,w,w,w,w,w,w,w,w,w,w,w,w,w,w,w,w,w,w,w,w,w,w,w,w,w,w,w,w,w,f,w,w,w,w,w,r,r,r,r,r,w,w
w,w,w,w,w,r,r,r,r,w,w,w,w,w,w,w,w,w,w,w,w,w,w,w,w,w,w,w,w,w,w,w,w,w,w,w,w,w,w,w,w,w,w,w,w,w,w,w,w,w,w,w,r,r,r,r,r,w,w,w
w,w,w,w,w,w,w,w,w,w,w,w,w,w,w,w,w,w,w,w,w,w,w,w,w,w,w,w,w,w,w,w,w,f,w,w,w,w,w,w,w,w,w,w,w,w,w,w,w,w,w,r,r,r,r,r,r,w,w,w
w,w,w,w,w,w,w,w,w,w,w,w,w,w,w,w,w,w,w,w,w,w,w,w,w,w,w,w,w,w,w,w,w,w,w,w,w,w,w,w,w,w,w,w,w,w,w,w,w,w,w,r,r,t,r,r,w,w,w,w
w,w,w,w,w,w,w,w,w,w,w,w,w,w,w,w,w,w,w,w,w,w,w,w,w,w,w,w,w,w,w,w,w,w,w,w,w,w,w,w,w,w,w,w,w,w,w,w,w,w,w,r,r,r,r,w,w,w,w,w
w,w,w,w,w,w,w,w,w,w,w,w,w,w,w,w,w,w,w,w,w,w,w,w,w,w,w,w,w,w,w,w,w,w,w,w,w,w,w,w,w,w,w,w,w,w,w,w,w,w,w,r,r,r,r,w,w,w,w,w
w,w,w,b,w,w,w,w,w,w,w,w,w,w,w,w,w,w,w,w,w,w,w,w,w,w,w,w,w,w,w,w,w,w,w,w,w,w,w,w,w,w,w,w,w,w,w,w,w,w,w,r,r,r,w,w,w,w,w,w
w,w,w,w,w,w,w,w,w,w,w,w,w,w,w,w,w,w,w,w,w,w,w,w,w,w,w,w,w,w,w,w,w,w,w,w,w,w,w,w,w,w,w,w,w,w,w,w,w,w,w,r,r,r,w,w,w,w,w,w
w,w,w,w,w,w,w,w,w,w,w,w,w,w,w,w,w,w,w,w,w,w,w,w,w,w,w,w,w,w,w,w,w,w,w,w,w,w,w,w,w,w,w,w,w,w,w,w,w,w,w,w,r,r,w,w,w,w,w,w
w,w,w,b,w,w,w,w,w,w,w,w,w,w,w,w,w,w,w,w,w,w,w,w,w,w,w,w,w,w,w,w,w,w,w,w,w,w,w,w,w,w,w,w,w,w,w,w,w,w,w,w,w,w,w,w,w,b,w,w
b,w,w,w,w,w,w,w,w,w,w,w,w,w,w,w,w,w,w,w,w,w,w,w,w,w,w,w,w,w,w,w,w,w,w,w,w,w,w,w,w,w,w,w,w,w,w,w,w,w,w,w,w,w,w,w,w,w,w,b
