w,w,w,w,w,w,w,w,w,w,w,w
w,w,w,w,w,w,w,w,w,w,w,w
w,a,w,w,w,r,r,r,r,r,r,w
w,w,w,w,w,r,w,w,w,w,r,w
w,w,w,w,w,r,w,f,w,w,r,w
w,w,w,w,w,r,w,w,w,f,r,w
w,w,w,w,w,r,w,f,w,w,r,w
w,w,w,w,w,r,w,w,w,w,r,w
w,w,w,w,w,r,w,w,f,w,r,w
w,w,w,w,w,r,r,r,r,r,r,w
w,w,w,w,w,w,w,w,w,w,w,w
w,w,w,w,w,w,w,w,w,w,w,w
